7
. . * * * . .
. . * * * . .
* * * * * * *
* * * o * * *
* * * * * * *
. . * * * . .
. . * * * . .
